...X./-L.......E....	
L---L..|X...L..X....
..L....|.../...L....
...\X..L--LX../.X...
...X\....X.\X/.L....
.....L......L.X|....
.....|..X.../..|....
....X|...../...LX...
.L---L...XL..X.|....
..\....../.....|....
...\X.../..X..XL....
....L--L....../.....
..X...X.\..X./......
......L--L--L.......
.....X.S/..X........