....................	
...X......L....L.X..
S-L...X../.\X..|...E
.\.X.L--LX..L--LX...
..L.............\...
...\............X\..
...XL....X........L.
....LX......L..X./..
.../X\.....X|.L-L...
..L---L.....L....X..
......|..../........
......|.../X........
....X.L--L..........
.......X............
....................