....................	
...........L.L--L--L
....X...../X/..X...|
...L--L../XL......X|
../.....L......L..XL
.LX......X......\./.
..\...XE.-L......L..
...L......|X.....|..
...|X.....|......|X.
..XL--L..XL...X..L..
.....X|...........\X
......L--L.........L
......X...\X..L--LX|
...........\./X...\|
X...........L......S