.............L......	
............/|......
......X.L--L.|......
........|....|.XL...
.......X|....L..|...
...X....L.....X.|...
.....X..|X...L--L.X.
...L--L.SX......|...
...X\.X..\....X.|X..
.....\....L-L...L...
.....XLX........X...
...../....X......E..
....L.L--L....X.L...
...X...X..\.X../....
...........L--L.....
