.........E..........	
....................
.........L..........
.....X...|.....X....
......L..|LL--L--L..
...../...LX../...|..
....L.X...../X...|..
...X.\.....L....XL..
......L....|..../...
.....X|....L..XL....
......|X...|...|....
......L--L...L.|....
......../.X./..LX...
.......L-S-L........